############################################################
#...................#.......#.......................#......#
#.#########.#######.#.###E#.#.#####################.#.####.#
#.#.......#.#.....#.#.#...#...#...................#.#.#..#.#
#.#.#####.#.#.###.#...#.#.#.#.#.####.############.#.#.#.##.#
#.#.#...#.#.#.#.#.#.#.#.#.#.#.#.#...............#.#.#.#..#.#
#.#.#.###.#.#.#.#.#.#.#.#.#.#.#.#.#############.#.#.#.##.#.#
#.#.#.....#.#.#.#.#.#.#.#.#.#.#.#.#...........#.#.#.#.#..#.#
#.#.#######.#.#.#.#.#.#.#.#.#.#.#.#.#########.#.#.#.#.#.##.#
#.#.........#.#.#...#.#.#.#...#.#.#.#.......#.#.#.#.#.#..#.#
#.###########.#.#####.#.#.#####.#.#.#.#####.#.#.#.#.#.##.#.#
#.............#.......#.#.......#.#.#.#...#...#.#.#.#.#..#.#
#############.#.#######.#########.#.#.#.#######.#.#.#.#.##.#
#.................................#.#.#.........#.#.#.#..#.#
#.#################################.#.###########.#.#.##.#.#
#...................................#.............#.#.#..#.#
#####################################.#############.#.#.##.#
#...................................................#.#..#.#
#.###################################################.##.#.#
#.....................................................#..#.#
#######################################################.##.#
#.......................................................#..#
#.#####################################################.##.#
#.......................................................#..#
#######################################################.##.#
#.......................................................#..#
#.#####################################################.##.#
#.......................................................#..#
#######################################################.##.#
#.......................................................#..#
#.#####################################################.##.#
#.......................................................#..#
#######################################################.##.#
#.......................................................#..#
#.#####################################################.##.#
#.......................................................#..#
#######################################################.##.#
#.......................................................#..#
#.#####################################################.##.#
#.......................................................#..#
#######################################################.##.#
#.......................................................#..#
#.#####################################################.##.#
#.......................................................#..#
#######################################################.##.#
#.......................................................#..#
#.#####################################################.##.#
#.......................................................#..#
...#########################################################
#.#####################################################.##.#
#.......................................................#..#
#######################################################.##.#
#.......................................................#..#
#.#####################################################.##.#
#.......................................................#..#
#######################################################.##.#
#.......................................................#..#
#.#####################################################.##.#
#..................................................E.......#
############################################################