############################################################
#..........................................................#
#.##############################.##################E######.#
#.#.................#....................................#.#
#.#.###############.####################################.#.#
#.#.#...............#..................................#.#.#
#.#.#.##########################..######################.#.#
#.#.#.#..............................................#.#.#.#
#.#.#.#.############################################.#.#.#.#
#.#.#.#.#..........................................#.#.#.#.#
#.#.#.#.#.########################################.#.#.#.#.#
#.#.#.#.#.#................................#.....#.#.#.#.#.#
#.#.#.#.#.#.##################.#################.#.#.#.#.#.#
#.#.#.#.#.#.#..................................#.#.#.#.#.#.#
#.#.#.#.#.#.#.################################.#.#.#.#.#.#.#
#.#.#.#.#.#.#.#..............................#.#.#.#.#.#.#.#
#.#.#.#.#.#.#.#.############################.#.#.#.#.#.#.#.#
#.#.#.#.#.#.#.#.#..........................#.#.#.#.#.#.#.#.#
#.#.#.#.#.#.#.#.#.########################.#.#.#.#.#.#.#.#.#
#.#.#.#.#.#.#.#.#.#......................#.#.#.#.#.#.#.#.#.#
#.#.#.#.#.#.#.#.#.#.####################.#.#.#.#.#.#.#.#.#.#
#.#.#.#.#.#.#.#.#.#.#..................#.#.#.#.#.#.#.#.#.#.#
#.#.#.#.#.#.#.#.#.#.#.################.#.#.#.#.#.#.#.#.#.#.#
#.#.#.#.#.#.#.#.#.#.#.#..............#.#.#.#.#.#.#.#.#.#.#.#
#.#.#.#.#.#.#.#.#.#.#.#.############.#.#.#.#.#.#.#.#.#.#.#.#
#.#.#.#.#.#.#.#.#.#.#.#.#..........#.#.#.#.#.#.#.#.#.#.#.#.#
#.#.#.#.#.#.#.#.#.#.#.#.#.########.#.#.#.#.#.#.#.#.#.#.#.#.#
#.#.#.#.#.#.#.#.#.#.#.#.#.#......#.#.#.#.#.#.#.#.#.#.#.#.#.#
#.#.#.#.#.#.#.#.#.#.#.#.#.#.####.#.#.#.#.#.#.#.#.#.#.#.#.#.#
#.#.#.#.#.#.#.#.#.#.#.#.#.#.#..#.#.#.#.#.#.#.#.#.#.#.#.#.#.#
#.#.#.#.#.#.#.#.#.#.#.#.#.#.#..#.#.#.#.#.#.#.#.#.#.#.#.#.#.#
#.#.#.#.#.#.#.#.#.#.#.#.#.#.####.#.#.#.#.#.#.#.#.#.#.#.#.#.#
#.#.#.#.#.#.#.#.#.#.#.#.#.#......#.#.#.#.#.#.#.#.#.#.#.#.#.#
#.#.#.#.#.#.#.#.#.#.#.#.#.########.#.#.#.#.#.#.#.#.#.#.#.#.#
#.#.#.#.#.#.#.#.#.#.#.#.#..........#.#.#.#.#.#.#.#.#.#.#.#.#
#.#.#.#.#.#.#.#.#.#.#.#.############.#.#.#.#.#.#.#.#.#.#.#.#
#.#.#.#.#.#.#.#.#.#.#.#..............#.#.#.#.#.#.#.#.#.#.#.#
#.#.#.#.#.#.#.#.#.#.#.################.#.#.#.#.#.#.#.#.#.#.#
#.#.#.#.#.#.#.#.#.#.#..................#.#.#.#.#.#.#.#.#.#.#
#.#.#.#.#.#.#.#.#.#.####################.#.#.#.#.#.#.#.#.#.#
#.#.#.#.#.#.#.#.#.#......................#.#.#.#.#.#.#.#.#.#
#.#.#.#.#.#.#.#.#.########################.#.#.#.#.#.#.#.#.#
#.#.#.#.#.#.#.#.#..........................#.#.#.#.#.#.#.#.#
#.#.#.#.#.#.#.#.############################.#.#.#.#.#.#.#.#
#.#.#.#.#.#.#.#..............................#.#.#.#.#.#.#.#
#.#.#.#.#.#.#.################################.#.#.#.#.#.#.#
#.#.#.#.#.#.#..................................#.#.#.#.#.#.#
#.#.#.#.#.#.####################################.#.#.#.#.#.#
#.#.#.#.#.#......................................#.#.#.#.#.#
#.#.#.#.#.########################################.#.#.#.#.#
#.#.#.#.#..........................................#.#.#.#.#
#.#.#.#.############################################.#.#.#.#
#.#.#.#..............................................#.#.#.#
#.#.#.################################################.#.#.#
#.#.#..................................................#.#.#
#.#.####################################################.#.#
#.#......................................................#.#
#.########################################################.#
#.........................................................E#
############################################################