############################################################
#...........................#..............................#
#.#####.###################.#.############################.#
#.#...#.#.................#.#.#..........................#.#
#.#.#.#.#.###############.#.#.#.########################.#.#
#.#.#.#.#.#.............#.#.#.#.#......................#.#.#
#.#.#.#.#.#.###########.#.#.#.#.#.####################.#.#.#
#.#.#.#.#.#.#.........#.#.#.#.#.#.#..................#.#.#.#
#.#.#.#.#.#.#.#######.#.#.#.#.#.#.#.################.#.#.#.#
#.#.#.#.#.#.#.#.....#.#.#.#.#.#.#.#.#..............#.#.#.#.#
#.#.#.#.#.#.#.#.###.#.#.#.#.#.#.#.#.#.############.#.#.#.#.#
#.#.#...#.#.#.#.#.#.#.#.#...#.#.#.#.#.#..........#.#.#.#.#.#
#.#.#####.#.#.#.#.#.#.#.#####.#.#.#.#.#.########.#.#.#.#.#.#
#.#.......#.#.#.#.#.#.#.......#.#.#.#.#.#......#.#.#.#.#.#.#
#.#########.#.#.#.#.#.#########.#.#.#.#.#.####.#.#.#.#.#.#.#
#...........#.#.#.#.#...........#.#.#.#.#.#..#.#.#.#.#.#.#.#
#.###########.#.#.#.###########.#.#.#.#.#.#..#.#.#.#.#.#.#.#
#.............#.#.#.............#.#.#.#.#.####.#.#.#.#.#.#.#
###############.#.###############.#.#.#.#......#.#.#.#.#.#.#
#...............#.................#.#.#.########.#.#.#.#.#.#
#.###############.###############.#.#.#..........#.#.#.#.#.#
#...............#...............#.#.#.############.#.#.#.#.#
###############.#.###############.#.#..............#.#.#.#.#
#...............#.................#.################.#.#.#.#
#.###############.###############.#..................#.#.#.#
#...............#...............#.####################.#.#.#
###############.#.###############......................#.#.#
#...............#.................#.####################.#.#
#.###############.###############.#......................#.#
#...............#...............#.######################.#.#
###############.#.###############........................#.#
#...............#.................######################.#.#
#.###############.###############........................#.#
#...............#...............#.######################.#.#
###############.#.###############........................#.#
#...............#.................######################.#.#
#.###############.###############........................#.#
#...............#...............#.######################.#.#
###############.#.###############........................#.#
#...............#.................######################.#.#
#.###############.###############........................#.#
#...............#...............#.######################.#.#
###############.#.###############........................#.#
#...............#.................######################.#.#
#.###############.###############........................#.#
#...............#...............#.######################.#.#
###############.#.###############........................#.#
#...............#.................######################.#.#
#.###############.###############........................#.#
#...............#...............#.######################.#.#
###############.#.###############........................#.#
#...............#.................######################.#.#
#.###############.###############........................#.#
#...............#...............#.######################.#.#
###############.#.###############........................#.#
#...............#.................######################.#.#
#.###############.###############........................#.#
#.................................#.####################.#.#
#.........................................................E#
############################################################