############################################################
#..#..............#...........#..#...........#.............#
#..#...........#..#...........#..#...........#.............#
#..#..#######..#..#..####..#..#..#..####..####..####..###..#
#.....#.....#..#.....#.....#........#..#........#..#..#..#.#
#.....#.....#..#.....#.....#........#..#........#..#..#..#.#
#######..####..#..####..#######..#..#..##########..#..#..#.#
#........#.....#..#.....#........#..#........#.....#..#....#
#........#.....#..#.....#........#..#........#.....#..#....#
#..####..#..#######..####..#######..#..####..####..#..#....#
#.....#..#..#........#..#..#.....#.....#..#........#..#..#.#
#.....#..#..#........#..#..#.....#.....#..#........#..#..#.#
####..#..#..#..#######..#..#..#..#######..#######..#..#..#.#
#.....#..#..#.....#.....#..#..#.....#..............#..#....#
#.....#..#..#.....#.....#..#..#.....#..............#..#....#
#..####..#..#..#..#..####..#..#..####..#############..#....#
#..#.....#..#..#..#........#..#...........#...........#....#
#..#.....#..#..#..#........#..#...........#...........#....#
#..#..####..#..#..##########..#############..#############.#
#..#.....#..#..#....................#.....#.....#.....#..#.#
#..#.....#..#..#....................#..#..#.....#.....#..###
#..####..#..#########################..#..####..#..#..#....#
#..#..#.....#...................................#..#.......#
#..#..#.....#...................................#..#.......#
#..#..#######..##################################..#..####.#
#..#.....#.....#................................#.....#....#
#..#.....#.....#................................#.....#....#
#..#..####..#..###################..#..##########..####....#
#..#........#........#...........#..#.....#.....#..#..#..###
#..#........#........#...........#..#.....#.....#..#..#....#
#..#######..#######..#..#######..#..####..#..#..#..#..#....#
#..#.....#........#.....#...........#..#.....#..#..#..#....#
#..#.....#........#.....#...........#..#..K..#..#..#.......#
#..#..#..####..#..#..####..#######..#..#######..#..#..###..#
#.....#........#........#.....#..............#.....#..#.#..#
#.....#........#........#.....#..............#.....#..#.#..#
######################..#..#..#############..#######..#....#
#..............#..#.....#..#.....#........#........#..#....#
#..............#..#.....#..#.....#........#........#..#....#
#..####..####..#..#..##########..#..#############..####....#
#.....#..#........#..............#..#...........#..#.....###
#.....#..#........#.................#...........#..#.......#
####..#..####..###################..#..#######..#..#..#....#
#..#..#.....#..#...........#........#..#.....#..#.....#....#
#..#..#.....#..#...........#........#..#.....#..#.....######
#..#..####..####..#..####..####..#..#..#..####..#######....#
#..#.....#..#.....#..#..#.....#..#..#..#..#...........#....#
#..#.....#..#.....#..#..#.....#..#..#..#..#...........#....#
#..#..#..#..#..####..#..####..####..#..#..#..#######..###..#
#..#..#..#.....#..#..#..............#.....#.....#.....#....#
#..#..#..#.....#..#..#..............#.....#.....#.....#....#
#..#..#..#######..#..#############..####..####..#######....#
#..#..#.....#.....#..............#..#.....#..#..#.........##
#..#..#.....#.....#..............#..#.....#..#.............#
#..####..#..####..#############..####..####..#.....#######D#
#..#.....#..................................#.....#........#
#..#.....############..#...###......#.......#######........#
#..#...###.............#.....##......#............#####....#
#........#.............#......#......#................#..E.#
############################################################